[
-----------------------------------|
-                                 -|
-                                 -|
-          *           ---       P-|
-    --                         ---|
-                                 -|
-                *                -|
-             -----               -|
--                                -|
-                         -       -|
-       --                        -|
-                                 -|
-                 --------        -|
-                                 -|
-    -----                        -|
-                               ---|
-             --                  -|
-                       *         -|
-----------------------------------|
]

player 50 50

portal 128 512 800 64

portal 200 400 700 64

monster 200 280 2 3 150 15

/